
1 1 1 1 1 1 1 1 1 1 1 1 1 1 1  -1
1 1 1 1 1 1 1 1 1 1 1 1 1 1 1  -1
1 1 1 1 1 1 1 1 1 1 1 1 1 1 1  -1
1 1 1 5 5 5 5 5 5 5 5 5 1 1 1  -1
1 1 1 5 5 5 5 5 5 5 5 5 1 1 1  -1
1 1 1 5 5 5 5 5 5 5 5 5 1 1 1  -1
1 1 1 5 5 5 5 5 5 5 5 5 1 1 1  -1
1 1 1 5 5 5 5 5 5 5 5 5 1 1 1  -1
1 1 1 5 5 5 5 5 5 5 5 5 1 1 1  -1
1 1 1 5 5 5 5 5 5 5 5 5 1 1 1  -1
1 1 1 5 5 5 5 5 5 5 5 5 1 1 1  -1
1 1 1 5 5 5 5 5 5 5 5 5 1 1 1  -1
1 1 1 1 1 1 1 1 1 1 1 1 1 1 1  -1
1 1 1 1 1 1 1 1 1 1 1 1 1 1 1  -1
1 1 1 1 1 1 1 1 1 1 1 1 1 1 1  -1
-2
2 2 2 2 2 2 2 2 2 2 2 2 2 2 2  -1
2 2 2 2 2 2 2 2 2 2 2 2 2 2 2  -1
2 2 0 3 2 2 2 2 2 2 2 3 0 2 2  -1
2 2 3 4 4 4 4 4 4 4 4 4 3 2 2  -1
2 2 8 4 0 0 4 0 4 0 0 4 8 2 2  -1
2 2 8 4 0 0 0 0 0 0 0 4 8 2 2  -1
2 2 8 4 0 0 0 0 0 0 0 4 8 2 2  -1
2 2 8 4 4 0 0 0 0 0 4 4 8 2 2  -1
2 2 8 4 0 0 0 0 0 0 0 4 8 2 2  -1
2 2 8 4 0 0 0 0 0 0 0 4 8 2 2  -1
2 2 8 4 0 0 0 0 0 0 0 4 8 2 2  -1
2 2 3 4 4 4 4 0 4 4 4 4 3 2 2  -1
2 2 0 3 8 8 2 2 2 8 8 3 0 2 2  -1
2 2 2 2 8 2 2 2 2 2 8 2 2 2 2  -1
2 2 2 2 2 2 2 2 2 2 2 2 2 2 2  -1
-2
0 0 0 0 0 0 0 0 0 0 0 0 0 0 0  -1
0 0 0 0 0 0 0 0 0 0 0 0 0 0 0  -1
0 0 0 3 0 0 0 0 0 0 0 3 0 0 0  -1
0 0 3 4 4 4 4 4 4 4 4 4 3 0 0  -1
0 0 0 7 0 0 0 0 0 0 0 7 0 0 0  -1
0 0 0 7 0 0 0 0 0 0 0 7 0 0 0  -1
0 0 0 7 0 0 0 0 0 0 0 7 0 0 0  -1
0 0 0 7 0 0 0 0 0 0 0 7 0 0 0  -1
0 0 0 7 0 0 0 0 0 0 0 7 0 0 0  -1
0 0 0 7 0 0 0 0 0 0 0 7 0 0 0  -1
0 0 0 7 0 0 0 0 0 0 0 7 0 0 0  -1
0 0 3 4 4 4 4 0 4 4 4 4 3 0 0  -1
0 0 0 3 8 0 0 0 0 0 8 3 0 0 0  -1
0 0 0 0 0 0 0 0 0 0 0 0 0 0 0  -1
0 0 0 0 0 0 0 0 0 0 0 0 0 0 0  -1
-2
0 0 0 0 0 0 0 0 0 0 0 0 0 0 0  -1
0 0 0 0 0 0 0 0 0 0 0 0 0 0 0  -1
0 0 0 3 0 0 0 0 0 0 0 3 0 0 0  -1
0 0 3 4 4 4 4 4 4 4 4 4 3 0 0  -1
0 0 3 4 0 0 0 0 0 0 0 4 3 0 0  -1
0 0 0 4 0 0 0 0 0 0 0 4 0 0 0  -1
0 0 0 4 0 0 0 0 0 0 0 4 0 0 0  -1
0 0 0 4 0 0 0 0 0 0 0 4 0 0 0  -1
0 0 0 4 0 0 0 0 0 0 0 4 0 0 0  -1
0 0 0 4 0 0 0 0 0 0 0 4 0 0 0  -1
0 0 3 4 0 0 0 0 0 0 0 4 3 0 0  -1
0 0 3 4 4 4 4 4 4 4 4 4 3 0 0  -1
0 0 0 3 0 0 0 0 0 0 0 3 0 0 0  -1
0 0 0 0 0 0 0 0 0 0 0 0 0 0 0  -1
0 0 0 0 0 0 0 0 0 0 0 0 0 0 0  -1
-2
0 0 0 0 0 0 0 0 0 0 0 0 0 0 0  -1
0 0 0 0 0 0 0 0 0 0 0 0 0 0 0  -1
0 0 0 3 0 0 0 0 0 0 0 3 0 0 0  -1
0 0 3 4 4 4 4 7 4 4 4 4 3 0 0  -1
0 0 3 3 0 0 0 0 0 0 0 3 3 0 0  -1
0 0 3 3 0 0 0 0 0 0 0 3 3 0 0  -1
0 0 3 3 0 0 0 0 0 0 0 3 3 0 0  -1
0 0 3 3 0 0 0 0 0 0 0 3 3 0 0  -1
0 0 3 3 0 0 0 0 0 0 0 3 3 0 0  -1
0 0 3 3 0 0 0 0 0 0 0 3 3 0 0  -1
0 0 3 3 0 0 0 0 0 0 0 3 3 0 0  -1
0 0 3 4 4 4 4 7 4 4 4 4 3 0 0  -1
0 0 0 3 0 0 0 0 0 0 0 3 0 0 0  -1
0 0 0 0 0 0 0 0 0 0 0 0 0 0 0  -1
0 0 0 0 0 0 0 0 0 0 0 0 0 0 0  -1
-2
0 0 0 0 0 0 0 0 0 0 0 0 0 0 0  -1
0 0 0 0 0 0 0 0 0 0 0 0 0 0 0  -1
0 0 0 0 3 0 0 0 0 0 3 0 0 0 0  -1
0 0 0 3 0 4 7 7 7 4 0 3 0 0 0  -1
0 0 0 6 0 0 0 0 0 0 0 6 0 0 0  -1
0 0 0 6 0 0 0 0 0 0 0 6 0 0 0  -1
0 0 0 6 0 0 0 0 0 0 0 6 0 0 0  -1
0 0 0 6 0 0 0 0 0 0 0 6 0 0 0  -1
0 0 0 6 0 0 0 0 0 0 0 6 0 0 0  -1
0 0 0 6 0 0 0 0 0 0 0 6 0 0 0  -1
0 0 0 6 0 0 0 0 0 0 0 6 0 0 0  -1
0 0 0 3 0 4 7 7 7 4 0 3 0 0 0  -1
0 0 0 0 3 0 0 0 0 0 3 0 0 0 0  -1
0 0 0 0 0 0 0 0 0 0 0 0 0 0 0  -1
0 0 0 0 0 0 0 0 0 0 0 0 0 0 0  -1
-2
0 0 0 0 0 0 0 0 0 0 0 0 0 0 0  -1
0 0 0 0 0 0 0 0 0 0 0 0 0 0 0  -1
0 0 0 0 3 0 0 0 0 0 3 0 0 0 0  -1
0 0 0 3 0 4 7 7 7 4 0 3 0 0 0  -1
0 0 0 6 0 0 0 0 0 0 0 6 0 0 0  -1
0 0 0 6 0 0 0 0 0 0 0 6 0 0 0  -1
0 0 0 6 0 0 0 0 0 0 0 6 0 0 0  -1
0 0 0 6 0 0 0 0 0 0 0 6 0 0 0  -1
0 0 0 6 0 0 0 0 0 0 0 6 0 0 0  -1
0 0 0 6 0 0 0 0 0 0 0 6 0 0 0  -1
0 0 0 6 0 0 0 0 0 0 0 6 0 0 0  -1
0 0 0 3 0 4 7 7 7 4 0 3 0 0 0  -1
0 0 0 0 3 0 0 0 0 0 3 0 0 0 0  -1
0 0 0 0 0 0 0 0 0 0 0 0 0 0 0  -1
0 0 0 0 0 0 0 0 0 0 0 0 0 0 0  -1
-2
0 0 0 0 0 0 0 0 0 0 0 0 0 0 0  -1
0 0 0 0 0 0 0 0 0 0 0 0 0 0 0  -1
0 0 0 0 3 0 0 0 0 0 3 0 0 0 0  -1
0 0 0 3 3 4 7 7 7 4 3 3 0 0 0  -1
0 0 0 6 3 0 0 0 0 0 3 6 0 0 0  -1
0 0 0 6 3 0 0 0 0 0 3 6 0 0 0  -1
0 0 0 6 3 0 0 0 0 0 3 6 0 0 0  -1
0 0 0 6 3 0 0 0 0 0 3 6 0 0 0  -1
0 0 0 6 3 0 0 0 0 0 3 6 0 0 0  -1
0 0 0 6 3 0 0 0 0 0 3 6 0 0 0  -1
0 0 0 6 3 0 0 0 0 0 3 6 0 0 0  -1
0 0 0 3 3 4 7 7 7 4 3 3 0 0 0  -1
0 0 0 0 3 0 0 0 0 0 3 0 0 0 0  -1
0 0 0 0 0 0 0 0 0 0 0 0 0 0 0  -1
0 0 0 0 0 0 0 0 0 0 0 0 0 0 0  -1
-2
0 0 0 0 0 0 0 0 0 0 0 0 0 0 0  -1
0 0 0 0 0 0 0 0 0 0 0 0 0 0 0  -1
0 0 0 0 0 3 0 0 0 3 0 0 0 0 0  -1
0 0 0 0 3 0 4 7 4 0 3 0 0 0 0  -1
0 0 0 0 6 0 0 0 0 0 6 0 0 0 0  -1
0 0 0 0 6 0 0 0 0 0 6 0 0 0 0  -1
0 0 0 0 6 0 0 0 0 0 6 0 0 0 0  -1
0 0 0 0 6 0 0 0 0 0 6 0 0 0 0  -1
0 0 0 0 6 0 0 0 0 0 6 0 0 0 0  -1
0 0 0 0 6 0 0 0 0 0 6 0 0 0 0  -1
0 0 0 0 6 0 0 0 0 0 6 0 0 0 0  -1
0 0 0 0 3 0 4 7 4 0 3 0 0 0 0  -1
0 0 0 0 0 3 0 0 0 3 0 0 0 0 0  -1
0 0 0 0 0 0 0 0 0 0 0 0 0 0 0  -1
0 0 0 0 0 0 0 0 0 0 0 0 0 0 0  -1
-2
0 0 0 0 0 0 0 0 0 0 0 0 0 0 0  -1
0 0 0 0 0 0 0 0 0 0 0 0 0 0 0  -1
0 0 0 0 0 3 0 0 0 3 0 0 0 0 0  -1
0 0 0 0 3 3 4 4 4 3 3 0 0 0 0  -1
0 0 0 0 6 3 0 0 0 3 6 0 0 0 0  -1
0 0 0 0 6 3 0 0 0 3 6 0 0 0 0  -1
0 0 0 0 6 3 0 0 0 3 6 0 0 0 0  -1
0 0 0 0 6 3 0 0 0 3 6 0 0 0 0  -1
0 0 0 0 6 3 0 0 0 3 6 0 0 0 0  -1
0 0 0 0 6 3 0 0 0 3 6 0 0 0 0  -1
0 0 0 0 6 3 0 0 0 3 6 0 0 0 0  -1
0 0 0 0 3 3 4 4 4 3 3 0 0 0 0  -1
0 0 0 0 0 3 0 0 0 3 0 0 0 0 0  -1
0 0 0 0 0 0 0 0 0 0 0 0 0 0 0  -1
0 0 0 0 0 0 0 0 0 0 0 0 0 0 0  -1
-2
0 0 0 0 0 0 0 0 0 0 0 0 0 0 0  -1
0 0 0 0 0 0 0 0 0 0 0 0 0 0 0  -1
0 0 0 0 0 0 3 0 3 0 0 0 0 0 0  -1
0 0 0 0 0 3 0 4 0 3 0 0 0 0 0  -1
0 0 0 0 0 6 0 0 0 6 0 0 0 0 0  -1
0 0 0 0 0 6 0 0 0 6 0 0 0 0 0  -1
0 0 0 0 0 6 0 0 0 6 0 0 0 0 0  -1
0 0 0 0 0 6 0 0 0 6 0 0 0 0 0  -1
0 0 0 0 0 6 0 0 0 6 0 0 0 0 0  -1
0 0 0 0 0 6 0 0 0 6 0 0 0 0 0  -1
0 0 0 0 0 6 0 0 0 6 0 0 0 0 0  -1
0 0 0 0 0 3 0 4 0 3 0 0 0 0 0  -1
0 0 0 0 0 0 3 0 3 0 0 0 0 0 0  -1
0 0 0 0 0 0 0 0 0 0 0 0 0 0 0  -1
0 0 0 0 0 0 0 0 0 0 0 0 0 0 0  -1
-2
0 0 0 0 0 0 0 0 0 0 0 0 0 0 0  -1
0 0 0 0 0 0 0 0 0 0 0 0 0 0 0  -1
0 0 0 0 0 0 3 0 3 0 0 0 0 0 0  -1
0 0 0 0 0 3 3 4 3 3 0 0 0 0 0  -1
0 0 0 0 0 6 3 0 3 6 0 0 0 0 0  -1
0 0 0 0 0 6 3 0 3 6 0 0 0 0 0  -1
0 0 0 0 0 6 3 0 3 6 0 0 0 0 0  -1
0 0 0 0 0 6 3 0 3 6 0 0 0 0 0  -1
0 0 0 0 0 6 3 0 3 6 0 0 0 0 0  -1
0 0 0 0 0 6 3 0 3 6 0 0 0 0 0  -1
0 0 0 0 0 6 3 0 3 6 0 0 0 0 0  -1
0 0 0 0 0 3 3 4 3 3 0 0 0 0 0  -1
0 0 0 0 0 0 3 0 3 0 0 0 0 0 0  -1
0 0 0 0 0 0 0 0 0 0 0 0 0 0 0  -1
0 0 0 0 0 0 0 0 0 0 0 0 0 0 0  -1
-2
0 0 0 0 0 0 0 0 0 0 0 0 0 0 0  -1
0 0 0 0 0 0 0 0 0 0 0 0 0 0 0  -1
0 0 0 0 0 0 0 3 0 0 0 0 0 0 0  -1
0 0 0 0 0 0 3 4 3 0 0 0 0 0 0  -1
0 0 0 0 0 0 6 4 6 0 0 0 0 0 0  -1
0 0 0 0 0 0 6 4 6 0 0 0 0 0 0  -1
0 0 0 0 0 0 6 4 6 0 0 0 0 0 0  -1
0 0 0 0 0 0 6 4 6 0 0 0 0 0 0  -1
0 0 0 0 0 0 6 4 6 0 0 0 0 0 0  -1
0 0 0 0 0 0 6 4 6 0 0 0 0 0 0  -1
0 0 0 0 0 0 6 4 6 0 0 0 0 0 0  -1
0 0 0 0 0 0 3 4 3 0 0 0 0 0 0  -1
0 0 0 0 0 0 0 3 0 0 0 0 0 0 0  -1
0 0 0 0 0 0 0 0 0 0 0 0 0 0 0  -1
0 0 0 0 0 0 0 0 0 0 0 0 0 0 0  -1
-2
0 0 0 0 0 0 0 0 0 0 0 0 0 0 0  -1
0 0 0 0 0 0 0 0 0 0 0 0 0 0 0  -1
0 0 0 0 0 0 0 0 0 0 0 0 0 0 0  -1
0 0 0 0 0 0 0 3 0 0 0 0 0 0 0  -1
0 0 0 0 0 0 0 6 0 0 0 0 0 0 0  -1
0 0 0 0 0 0 0 6 0 0 0 0 0 0 0  -1
0 0 0 0 0 0 0 6 0 0 0 0 0 0 0  -1
0 0 0 0 0 0 0 6 0 0 0 0 0 0 0  -1
0 0 0 0 0 0 0 6 0 0 0 0 0 0 0  -1
0 0 0 0 0 0 0 6 0 0 0 0 0 0 0  -1
0 0 0 0 0 0 0 6 0 0 0 0 0 0 0  -1
0 0 0 0 0 0 0 3 0 0 0 0 0 0 0  -1
0 0 0 0 0 0 0 0 0 0 0 0 0 0 0  -1
0 0 0 0 0 0 0 0 0 0 0 0 0 0 0  -1
0 0 0 0 0 0 0 0 0 0 0 0 0 0 0  -1