
1 1 1 1 1 1 1 1 1 1 1 1 1 1 1  -1
1 1 1 1 1 1 1 1 1 1 1 1 1 1 1  -1
1 1 1 1 1 1 1 1 1 1 1 1 1 1 1  -1
1 1 1 5 5 5 5 5 5 5 5 5 1 1 1  -1
1 1 1 5 5 5 5 5 5 5 5 5 1 1 1  -1
1 1 1 5 5 5 5 5 5 5 5 5 1 1 1  -1
1 1 1 5 5 5 5 5 5 5 5 5 1 1 1  -1
1 1 1 5 5 5 5 5 5 5 5 5 1 1 1  -1
1 1 1 5 5 5 5 5 5 5 5 5 1 1 1  -1
1 1 1 5 5 5 5 5 5 5 5 5 1 1 1  -1
1 1 1 5 5 5 5 5 5 5 5 5 1 1 1  -1
1 1 1 5 5 5 5 5 5 5 5 5 1 1 1  -1
1 1 1 1 1 1 1 1 1 1 1 1 1 1 1  -1
1 1 1 1 1 1 1 1 1 1 1 1 1 1 1  -1
1 1 1 1 1 1 1 1 1 1 1 1 1 1 1  -1
-2
2 2 2 2 2 2 2 2 2 2 2 2 2 2 2  -1
2 2 2 2 2 2 2 2 2 2 2 2 2 2 2  -1
2 2 3 3 2 2 2 2 2 2 2 3 3 2 2  -1
2 2 3 4 4 4 4 4 4 4 4 4 3 2 2  -1
2 2 2 4 0 0 4 0 4 0 0 4 2 2 2  -1
2 2 2 4 0 0 0 0 0 0 0 4 2 2 2  -1
2 2 2 4 0 0 0 0 0 0 0 4 2 2 2  -1
2 2 2 4 4 0 0 0 0 0 4 4 2 2 2  -1
2 2 2 4 0 0 0 0 0 0 0 4 2 2 2  -1
2 2 2 4 0 0 0 0 0 0 0 4 2 2 2  -1
2 2 2 4 0 0 0 0 0 0 0 4 2 2 2  -1
2 2 3 4 4 4 4 0 4 4 4 4 3 2 2  -1
2 2 3 3 2 2 2 2 2 2 2 3 3 2 2  -1
2 2 2 2 2 2 2 2 2 2 2 2 2 2 2  -1
2 2 2 2 2 2 2 2 2 2 2 2 2 2 2  -1